11111111111111111111
10CE0111111111111111
10101C000000000000C1
10100P00000000000011
1P00000C000000000011
11111111111111111111